*************Hello World****************

By Dian Brown

---------------------------0-------------1-----------4---44----
-------------------2---------1-----------2------------2--------
-------------------12----------23---------23-------------23----
-----------------1---------------------------------------------
-------------2------------1----------------------2-----------2-
-------2----------1-----------------------------3--------------